===CHIPS===		

---Starter Chips---		

AirShot (__S__)	Shot	[Starter]	
Attack+1 (__S__)	Support	[Starter]	
Barrier (__S__)	Support	[Starter]	
Bubbler (__S__)	Shot	[Starter]	
Cannon (__S__)	Shot	[Starter]	
DashAttack (__S__)	Rush	[Starter]	
HeatShot (__S__)	Shot	[Starter]	
Plasma (__S__)	Impact	[Starter]	
Repair (__S__)	Support	[Starter]	
RockCube (__S__)	Summon	[Starter]	
Sword (__S__)	Blade	[Starter]	
ZapRing (__S__)	Shot	[Starter]	

---Blade Chips---		

AirSword	Blade	
AquaSword	Blade	
AscensionSlash	Blade	
BambooSword	Blade	
ChainRod	Blade	
CrystalBlade	Blade	[C-License]	
CustSword	Blade	
DataDaggers	Blade	
DoubleEdge	Blade	
ElecSword	Blade	
FireSword	Blade	
HeroSword	Blade	
ICEPick	Blade	
IceSkates	Blade	
KnightSword	Blade	
LaserRazor	Blade	[S-License]	
LightningFoil	Blade	
LightWave	Blade	
MirrorSword	Blade	[A-License]	
PaladinSword	Blade	
RecoilRod	Blade	
SlashClaw	Blade	
Slasher	Blade	
StyleSword	Blade	
TripleRod	Blade	
TurboSlice	Blade	
VarSword	Blade	
VesselBlade	Blade	
Z-Saber	Blade	

---Hazard Chips---		

AreaGrab	Hazard	
BurnSquare	Hazard	
Geddon1	Hazard	
Geddon2	Hazard	
Geyser	Hazard	
GhostSeed	Hazard	[C-License]	
GhostStage	Hazard	
Grabby	Hazard	[S-License]	
GrassSeed	Hazard	
GrassStage	Hazard	
IceSeed	Hazard	
IceStage	Hazard	
LavaSeed	Hazard	
LavaStage	Hazard	
MagSeed	Hazard	
MetalGears	Hazard	
MetalStage	Hazard	
PoisonSeed	Hazard	
SandRing	Hazard	[A-License]	
SandSeed	Hazard	
SandStage	Hazard	
Springboard	Hazard	
WaterSeed	Hazard	
WaterStage	Hazard	
Whirlpool	Hazard	
WhiteWeb	Hazard	
WoolSeed	Hazard	

---Impact Chips---		

BalanceStaff	Impact	
BronzeFist	Impact	[S-License]	
BubbleParasol	Impact	
ColdPunch	Impact	
CopyStrike	Impact	
DizzyHit	Impact	
DrillArm	Impact	
EMPunch	Impact	
FinalBlow	Impact	
FireHit	Impact	
GoldFist	Impact	
GravityHold	Impact	
GutPunch	Impact	
GutStraight	Impact	[A-License]	
Hammer	Impact	
MagCoil	Impact	
Nullifier	Impact	
PercussiveFix	Impact	
PhantomGrasp	Impact	
PowerCycle	Impact	
PressurePoint	Impact	
RiseNShine	Impact	
SilverFist	Impact	
SnakeBite	Impact	
TopSpin	3	Impact	
Uninstall	Impact	
WhirlwindToss	Impact	
WindRack	Impact	
ZeroKnuckle	Impact	[C-License]	

---Rush Chips---		

AquaWhirl	Rush	
Arrow	Rush	
BlizzardBall	Rush	
Condor	Rush	
CurseShield	Rush	
FootStomp	Rush	
GoingRoad	Rush	
IronShell	Rush	
LineOut	Rush	
MetaGel	Rush	[S-License]	
PowerSlide	Rush	
Pyrotechnics	Rush	
Quake	Rush	
RadicalGrind	Rush	
Recharger	Rush	
RewindDash	Rush	
RocketTackle	Rush	
RollFlash	Rush	[A-License]	
SandWorm	Rush	
ShiningArmor	Rush	
ShortCircuit	Rush	
StepCross	Rush	
StepSword	Rush	
Stringer	Rush	
SwordsDance	Rush	
TurboTire	Rush	
Vault	Rush	[C-License]	
WebSurfer	Rush	
YokuTrail	Rush	

---Shot Chips---		
	
AtomicFire	Shot	
Boomer	Shot	
Catapult	Shot	
ConcreteShot	Shot	
CornShot	Shot	
Crackshot	Shot	
CurtainFire	Shot	
Detonator	Shot	
DiffusalCannon	Shot	[A-License]	
Drain	Shot	
DrillBomb	Shot	
GeminiLaser	Shot	
Grappler	Shot	[C-License]	
Highlighter	Shot	
HomingTorpedo	Shot	
IceSlasher	Shot	[S-License]	
LavaCannon	Shot	
MarkCannon	Shot	
MetalBlade	Shot	
NeedleCannon	Shot	
ShotGun	Shot	
TankCannon	Shot	
Thunder	Shot	
VarGun	Shot	
Yo-Yo	Shot	

---Summon Chips---		

AirRaid	Summon	
Anubis	Summon	
Candle	Summon	
Catcher	Summon	
Decoy	Summon	
ElecReel	Summon	
FireRat	Summon	
GhostGloves	Summon	[A-License]
GreenCarpet	Summon	
Guardian	Summon	
HolyPanel	Summon	
IceCube	Summon	
Insert	Summon	[C-License]	
IronShield	Summon	
Meteors	Summon	
Mine	Summon	
MokoRush	Summon	
Mole	Summon	[C-License]	
PopUp	Summon	
RainyDay	Summon	
Ratton	Summon	
Recall	Summon	
RiskyHoney	Summon	
RockArm	Summon	
Rook	Summon	
Rope	Summon	
Sensor	Summon	[S-License]	
Silence	Summon	
SnakeCharmer	Summon	
TimeBomb	Summon	
Totem	Summon	
Wind	Summon	

---Support Chips---		

AirShoes	Support	
Blinder	Support	
Braveheart	Support	
BubbleStar	Support	
ColorPoint	Support	
CopyDamage	Support	
Dropdown	Support	
Fanfare	Support	[A-License]	
FolderRewind	Support		
GeminiTwin	Support	
Guard	Support	
HiveShield	Support	
Invis	Support	
LeafShield	Support	
MapView	Support	
Recover3	Support	
Recover5	Support	
Reflex	Support	
Shadow	Support	
SkullBarrier	Support	
StoneBody	Support	
Sweetheart	Support	
SystemScan	Support	
TimeCancel	Support	
TimeStopper	Support	[S-License]	
Timpani	Support	
TundraSpotlight	Support	

---Thrown Chips---		

AirBomb	2	Thrown	
AirSpin	2	Thrown	
Airstrike	Thrown	
BlackBomb	Thrown	
Cactiball	Thrown	
ChainBlast	Thrown	
DiceBomb	Thrown	
Firecracker	Thrown	
FlamingLasso	Thrown	
FlashBomb	Thrown	
GutsShoot	Thrown	[S-License]	
IceBall	Thrown	
Kunai	Thrown	
LastOut	Thrown	
Lavaball	Thrown	
LightningRod	Thrown	
LogicBomb	Thrown	
MagBomb	Thrown	
Magnum	Thrown	
MiniBomb	Thrown	
Mudball	Thrown	
QuickRound	Thrown	
RollingShield	Thrown	
SeekBomb	Thrown	
ShieldBoomerang	Thrown	
StickyStick	Thrown	[C-License]	
SwapRing	Thrown	[A-License]	
TreeBomb	Thrown	
VesselBomb	Thrown	
ZapNet	Thrown	

---Wave Chips---		

AquaTower	Wave	
BigHeart	Wave	
BigWave	3	Wave	
BlackWing	Wave	
BrowserCrasher	Wave	
BurstRevenge	Wave	
CandyWave	Wave	
CashFlow	Wave	
CustomVolt	Wave	
DesertLions	Wave	
DimensionalGate	Wave	
FireBurner	Wave	
FireTower	Wave	
GunDelSol	Wave	
Hell'sRolling	Wave	
IceWave	2	Wave	
MudWave	2	Wave	
MysticMist	Wave	
NOBeam	3	Wave	
NorthWind	Wave	
Poltergeist	Wave	[A-License]	
Pulsar	1	Wave	
RedWave	2	Wave	
SonicWave	Wave	
Spice	Wave	
TidalWave	Wave	
ToadMelody	Wave	[S-License]	
Tornado	Wave	
WoodTower	Wave	
YamatoRush	Wave	[C-License]	

---MEGA Chips---		

Aura	Support	[Mega]	
Avatar	Support	[Mega]	
BlackHoleBomb	Thrown	[Mega]	
CornFiesta	Wave	[Mega]	
DeltaRayEdge	Rush	[Mega]	
ElementalSonicWave	Blade	[Mega]	
ElementSurge	Wave	[Mega]	
GateMagic	Summon	[Mega]	
MeteorKnuckle	Impact	[Mega]	
NaviRecycle	NaviChip	[Mega]	
SuperVulcan	Shot	[Mega]	
UnityBoost	Shot	[Mega]	

---Dark Chips---		

AlphaClaw	Blade	[Dark]	
ApexPredator	Impact	[Dark]	
BeastOver	Rush	[Dark]	
BitterTalon	Blade	[Dark]	
DarkBomb	Thrown	[Dark]	
DarkBrand	Impact	[Dark]	
DarkBrush	Thrown	[Dark]	
DarkCannon	Shot	[Dark]	
DarkCircle	Shot	[Dark]	
DarkDrill	Impact	[Dark]	
DarkFlame	Wave	[Dark]	
DarkHeart	Support	[Dark]	
DarkInsert	Snmmon	[Dark]	
DarkInvisible	Support	[Dark]	
DarkKnuckle	Impact	[Dark]	
DarkLance	Rush	[Dark]	
DarkLantern	Summon	[Dark]	
DarkMeteor	Summon	[Dark]	
DarkMist	Hazard	[Dark]	
DarkPick	Blade	[Dark]	
DarkPlus	Support	[Dark]	
DarkRecall	Summon	[Dark]	
DarkRecover	Support	[Dark]	
DarkSnake	Impact	[Dark]	
DarkSound	Summon	[Dark]	
DarkSpread	Impact	[Dark]	
DarkStage	Hazard	[Dark]	
DarkStrings	Thrown	[Dark]	
DarkSword	Blade	[Dark]	
DarkThunder	Wave	[Dark]	
DarkTornado	Wave	[Dark]	
DarkVulcan	Shot	[Dark]	
DarkWide	Wave	[Dark]	
DarkWorm	Rush	[Dark]	
FlashMemory	Support	[Dark]	
GraveBreath	Hazard	[Dark]	
JusticeFist	Impact	[Dark]	

---ChitChat CrossOver Chips---		

CritterCrew	Summon	[ChitChat]	
EleMentalist	Summon	[ChitChat]	
Jamout	Wave	[ChitChat]	
Offdoff	Impact	[ChitChat]	
PawClaw	Blade	[ChitChat]	
Redecorator	Summon	[ChitChat]	

---Radical Spin CrossOver Chips---		

AestheticShuffle	Support	[Radical Spin]	
DashSpin	Rush	[Radical Spin]	
Faker	Summon	[Radical Spin]	
FlameShield	Rush	[Radical Spin]	
KnuckleSpikes	Impact	[Radical Spin]	
OpenYourHeart	Support	[Radical Spin]	
PerfectChaos	Hazard	[Radical Spin]	
ThunderShield	Support	[Radical Spin]	
WaterShield	Support	[Radical Spin]	

---UndergroundBroadcast CrossOver Chips---		



---Mystic Lilies CrossOver Chips---		

AceOfSpades	Support	[Mystic Lilies]
BadApple	Summon	[Mystic Lilies]
InstantKarma	Summon	[Mystic Lilies]
MoonLight	Hazard	[Mystic Lilies]
Possession	Support	[Mystic Lilies]
ThirdEye	Shot	[Mystic Lilies]
WanderingSin	Shot	[Mystic Lilies]

===NCPs===		

---1EB NCPs---		

ActionReplay(NCP)	1EB	[Skateboard Dog]
Aggregator	1EB	[Analyze]
AutoWrite	1EB	[Reconfig]
BackupRoutine	1EB	[Afterimages]
BaRecycle	1EB	
Barrage	1EB	[Volley]
Bastion	1EB	[HyperArmor]
Brand	1EB	
BurstMod	1EB	[Splash]
ContentAware	1EB	
Designer	1EB	[ModelEdit]
Dullahan	1EB	
Efficiency	1EB	[Afterimages]
EncryptedChat(NCP)	1EB	[ChitChat]
Extrapolator	1EB	[Tracker]
EvilMind	1EB	
Forward	1EB	[Reflect]
GeoTracker	1EB	
GlowMode	1EB	
GutStrike	1EB	[Gutsy]
Harmonizer	1EB	
HazardTimer	1EB	
Incognito	1EB	[Harmless]
Infiltrate	1EB	[Shatter]
Influencer	1EB	[Overwrite]
Inspire	1EB	[Rally]
Launcher	1EB	[Gutsy]
Mascot	1EB	[Harmless]
Matchmaker(NCP)	1EB	[Skateboard Dog]
MegaFlex	1EB	
Megaphone	1EB	
Meld	1EB	[Shift]
NowRecording	1EB	
Pathfind	1EB	[Sneakrun]
PocketBase(NCP)	1EB	[ChitChat]
ProgBody	1EB	
ProgRadar	1EB	
Projector	1EB	[Tracker]
RAMWipe	1EB	[Clear]
Refine	1EB	[Extend]
Ricochet	1EB	[Volley]
RideOn(NCP)	1EB	[Skateboard Dog]
SaveAs	1EB	[Save]
Setup	1EB	[LockOn]
SideLoad	1EB	[CodeInjection]
SignPost	1EB	
SnakeEyes	1EB	[Glare]
Soundboard	1EB	[Playback]
Subliminal	1EB	[Hypnotize]
TeamBreak	1EB	[Breakcharge]
TexturePack	1EB	[MapEdit]
ThemeSong	1EB	
Underflow	1EB	
Universal	1EB	[CodeInjection]
ZennyMiner	1EB	

---2EB NCPs---		

Anticipation	2EB	[Foresight]
AntiCollider	2EB	[NoClip]
Arena	2EB	[Duel]
AsynchronousI/O	2EB	
Back2Back	2EB	
Backtrace	2EB	[Firewall]
BarrelProcessor	2EB	
BladeRun	2EB	
BlastOff	2EB	[JumpJets]
Blowback	2EB	[Followthrough]
Callout	2EB	[Glare]
CashOut	2EB	
Chain	2EB	[Extend]
Cloak	2EB	[Sneakrun]
Collect	2EB	
ControlA	2EB	[Control]
Daredevil	2EB	[Bodyguard]
Debilitate	2EB	[Breakcharge]
Defrag	2EB	[Clear]
Demolition	2EB	[Shatter]
Diffusal	2EB	
Elegance	2EB	[ArtfulDodger]
ElemenTango	2EB	[Save]
ElemRitual	2EB	
EnviroScan	2EB	[BlindMode]
Essence	1EB	[Regenerate]
Evacuate	2EB	[Foresight]
Exploit	2EB	[Analyze]
Feedback	2EB	[Playback]
Feint	2EB	[ArtfulDodger]
Flurry	2EB	[Vengeance]
ForceRefresh	2EB	[Refresh]
Gladiator	2EB	[Duel]
HP+2	2EB	
Interception	2EB	[LockOn]
LastHit	2EB	[Followthrough]
MagnetArmor	2EB	[KineticArmor]
Monitor	2EB	[BlindMode]
Motorize	2EB	[MapEdit]
Overheal	2EB	[Regenerate]
PassengerMode	2EB	
Payload	2EB	[Alt]
Pettaur	2EB	
ProgPal(NCP)	2EB	[ChitChat]
Protector	2EB	[Bodyguard]
Recall	2EB	[Warp]
Redirect	2EB	[Shift]
RemoteDet	2EB	[Splash]
RocketFist	2EB	
Rupture	2EB	[Disruption]
SearchOptimized	2EB	
SetElement	2EB	
Specialist	2EB	[Rally]
StrikeBack	2EB	[Reflect]
SuperArmor	2EB	
Tantrum	2EB	[Vengeance]
Tinker	2EB	[HotSwap]
Trailblazer	2EB	
Transmission	2EB	[Warp]
Tremor	2EB	[Shockwave]
Ventrillo	2EB	
WaveMod	2EB	[Shockwave]
WaveRider	2EB	
ZealOverdrive	2EB	[KineticArmor]

---3EB NCPs---		

AltTab	3EB	[Alt]
AttackUp	3EB	
ControlX	3EB	[Control]
Custom+2	3EB	
DualPipeline	3EB	
EnergyChange	3EB	
ExecutionUnit	3EB	
Fabricator	3EB	[ModelEdit]
FirstBarrier	3EB	
Fizzle	3EB	[NoClip]
FloatShoes	3EB	
Hijack	3EB	[Reconfig]
HP+4	3EB	
HypnoFlash	3EB	[Hypnotize]
Impact	3EB	[JumpJets]
KingOfDiamonds(NCP)	3EB	[Mystic Lilies]
Lockdown	3EB	[HyperArmor]
Portal	3EB	[Firewall]
Press	3EB	
RedundantArray	3EB	
Reroute	3EB	[HotSwap]
Retry	3EB	[Refresh]
Scrambler	3EB	[Disruption]
SoulUnion	3EB	
Sprite	3EB	
Tamer	3EB	[Overwrite]
UnderShirt	3EB	
VolatileMemory	3EB	
ZeroWaitState	3EB	
Mind Power NCP	3EB	
Body Power NCP	3EB	
Soul Power NCP	3EB	
LockOn NCP	3EB	
Volley NCP	3EB	
BlindMode NCP	3EB	
Splash NCP	3EB	
Tracker NCP	3EB	
Refresh NCP	3EB	
Reconfig NCP	3EB	
Analyze NCP	3EB	
Foresight NCP	3EB	
Extend NCP	3EB	
MapEdit NCP	3EB	
HotSwap NCP	3EB	
Disruption NCP	3EB	
Firewall NCP	3EB	
NoClip NCP	3EB	
BreakCharge NCP	3EB	
Followthrough NCP	3EB	
Gutsy NCP	3EB	
Shockwave NCP	3EB	
Shatter NCP	3EB	
Warp NCP	3EB	
Afterimages NCP	3EB	
JumpJets NCP	3EB	
Sneakrun NCP	3EB	
ArtfulDodger NCP	3EB	
Regenerate NCP	3EB	
Clear NCP	3EB	
KineticArmor NCP	3EB	
Reflect NCP	3EB	
HyperArmor NCP	3EB	
Overwrite NCP	3EB	
ModelEdit NCP	3EB	
Playback NCP	3EB	
Harmless NCP	3EB	
Hypnotize NCP	3EB	
Rally NCP	3EB	
Bodyguard NCP	3EB	
Vengeance NCP	3EB		
Glare NCP	3EB	
Duel NCP	3EB	
Save NCP	3EB	
CodeInjection NCP	3EB	
Shift NCP	3EB	
Control NCP	3EB	
Alt NCP	3EB	

---4EB NCPs---		

AddOn	4EB	
ChameleoCloak	4EB	
KernelPanic	4EB	
Meltdown	4EB	
MimicStrike	4EB	
Proxy	4EB	

---5EB NCPs---		

Body+1	5EB
LastStand	5EB	
Mega+1	5EB	
Mind+1	5EB	
Soul+1	5EB	

---7EB NCPs---		

SingatureMove	7EB	

---Navi Powers---		

BlindMode	Sense	
Splash	Sense	
Tracker	Sense	
LockOn	Sense	
Volley	Sense	
Analyze	Info	
Foresight	Info	
Extend	Info	
Reconfig	Info	
Refresh	Info	
Disruption	Coding	
Firewall	Coding	
NoClip	Coding	
MapEdit	Coding	
HotSwap	Coding	
Gutsy	Strength	
Shockwave	Strength	
Shatter	Strength	
Breakcharge	Strength	
Followthrough	Strength	
JumpJets	Speed	
SneakRun	Speed	
ArtfulDodger	Speed	
Warp	Speed	
Afterimages	Speed	
KineticArmor	Stamina	
Reflect	Stamina	
HyperArmor	Stamina	
Regenerate	Stamina	
Clear	Stamina	
Playback	Charm	
Harmless	Charm	
Hypnotize	Charm	
Overwrite	Charm	
ModelEdit	Charm	
Vengeance	Bravery	
Glare	Bravery	
Duel	Bravery	
Rally	Bravery	
Bodyguard	Bravery	
Shift	Affinity	
Control	Affinity	
Alt	Affinity	
Save	Affinity	
CodeInjection	Affinity	

You found an Easter Egg! #6 out of 10! (5)	Secret	[Hidden]